###############################
#.@..#........................#
#....#.........g..............#
####.#....................g...#
#.............................#
#....#########................#
#............#................#
#............#.....g..........#
#............#................#
#............##########.......#
#.....g.......................#
#.............................#
#......................d......#
#.............................#
###############################